##################################################################
# k                                                              #
#                                                                #
#                     E                      E                 pp#
# P                                                            pk#
#                                E                             pp#
#                                                                #
#i                                                               #
##################################################################