##################################################################
#                 P                                              #
#                              bbb       pppppp                  #
#   k                          bkb       p    p                  #
#                              bbb       p  k p                  #
#     l        l         l        l      pppppp      l      l    #
#                                                         k      #
#                   i                                            #
##################################################################