##############################################################################################################
#     ###         bbb     bbbb                     bbb                                                      p#
#  l  ###                                                                                            E       #
#     ###   p    p    p         p    p    p    p               b               E                             #
#     ###             k                                                                  k                   #
#     ###   p                                  p                                  b                          #
#     ###       l           l            l                                                  l        b       #
#  P  ###   p                                  p                                                             #
#     ###                                                                     b                              #
#     ###   p    p    p         p    p    p    p                b                                            #
#     ###                                                                        b          l    b           #
#     ################        ###############           b                                                    #
#      ###############        ###############                              b                           b     #
#                             ###############b                                                               #
#                                                                b                 b        l                #
#                 l                                   l                                             E        #
#                                                                                                            #
###    ###############b  b  b###########p  p################ p p ###########                                 #
###    ###    ########ppppppp###########    ################ p p ###########       bbbbb                     #
### l  ###    ######## ##############          ############# p p ###########                l   b            #
###    ###    ######                                ######## p p ###########                                 #
###    ###    ######    l                     l     ######## p p ###########       b                         #
###           ######               i                ######## p p ###########                                 #
###    ###    ######b                               ######## p p ###########                l        b       #
### l  ###### ################ ############################# p p ###########bb             E                 #
###    ######          k       ##########################          k        bb                               #
##################### ######################################################                                 #
###                                                                      k #                l          E     #
###                                                                        #       bbbbb                     #
###                                                E                       #                    b            #
###       l      E      l                 l                    l           #                                 #
###                                                                        #       b        l                #
###                                                                        #                                 #
###                                                                        #                         b       #
###    ######                  ##############################  p  ##########bb                               #
###    ######                  ##########################                   bbbbb                            #
##############################################################################################################