#######################################
#p      bb         k                 p#
#                                     #
#                   b                 #
#     P             b                 #
#                   b               k #
#                                     #
#                   RRGGBB            #
#                   RRGGBB            #
#p     k    b                 b      p#
#######################################